Sugar, Sugar – The Archies
Aquarius/Let the Sunshine In – The 5th Dimension
Honky Tonk Women – The Rolling Stones

Bridge Over Troubled Water – Simon & Garfunkel
(They Long to Be) Close to You – The Carpenters
Let It Be – The Beatles

Joy to the World – Three Dog Night
Maggie May – Rod Stewart
Imagine – John Lennon

The First Time Ever I Saw Your Face – Roberta Flack
Alone Again (Naturally) – Gilbert O’Sullivan
American Pie – Don McLean

Tie a Yellow Ribbon Round the Ole Oak Tree – Tony Orlando and Dawn
Bad, Bad Leroy Brown – Jim Croce
Superstition – Stevie Wonder

The Way We Were – Barbra Streisand
Seasons in the Sun – Terry Jacks
Sweet Home Alabama – Lynyrd Skynyrd

Love Will Keep Us Together – Captain & Tennille
Rhinestone Cowboy – Glen Campbell

Silly Love Songs – Wings
Don’t Go Breaking My Heart – Elton John & Kiki Dee
Hotel California – Eagles

Tonight’s the Night – Rod Stewart
I Just Want to Be Your Everything – Andy Gibb
Dreams – Fleetwood Mac

Shadow Dancing – Andy Gibb
Night Fever – Bee Gees
Stayin’ Alive – Bee Gees

My Sharona – The Knack
Bad Girls – Donna Summer
I Will Survive – Gloria Gaynor

Call Me – Blondie
Another Brick in the Wall (Part II) – Pink Floyd
You Shook Me All Night Long – AC/DC

Bette Davis Eyes – Kim Carnes
Endless Love – Diana Ross & Lionel Richie
In the Air Tonight – Phil Collins

Physical – Olivia Newton-John
Eye of the Tiger – Survivor
Tainted Love – Soft Cell

Every Breath You Take – The Police
Billie Jean – Michael Jackson
Sweet Dreams (Are Made of This) – Eurythmics

When Doves Cry – Prince
What’s Love Got to Do with It – Tina Turner
Jump – Van Halen

Careless Whisper – George Michael
Like a Virgin – Madonna
Born in the U.S.A. – Bruce Springsteen

That’s What Friends Are For – Dionne & Friends
Say You, Say Me – Lionel Richie
Take On Me – a-ha

Walk Like an Egyptian – The Bangles
Alone – Heart
With or Without You – U2

Faith – George Michael
Need You Tonight – INXS
Sweet Child o’ Mine – Guns N’ Roses

Look Away – Chicago
My Prerogative – Bobby Brown
Fast Car – Tracy Chapman

Hold On – Wilson Phillips
It Must Have Been Love – Roxette
Nothing Compares 2 U – Sinéad O’Connor
